Charles Wright & The Watts 103rd Street Rhythm Band - Express Yourself, 0
De La Soul - Ring Ring Ring (Ha Ha Hey), 0
James Brown - Blind Man Can See It, 0
James Knight And The Butlers - Save Me, 0
Otis Redding - (Sittin' On) The Dock Of The Bay, 0
The J.B.'s - Pass The Peas, 0
Ann Allford - Gotta Get Me A Job, 2
Evinha - Que Bandeira, 2
Jurassic 5 - I Am Somebody (Instrumental), 2
Astrud Gilberto - Take It Easy, My Brother Charlie, 3
De La Soul - 4 More (feat. Zhane), 3
DJ Jazzy Jeff And The Fresh Prince - Summertime (Instrumental), 3
Tosca - Boss On The Boat, 4
Bill Withers - The Same Love That Made Me Laugh, 4
Beastie Boys - Shadrach (Instrumental), 3
Lee Perry - Jungle Lion, 3
Jurassic 5 - Improvise (Instrumental), 4
The Marvels - Rock Steady, 3
Nightmares On Wax - You Wish, 3
Bomb The Bass - Bug Powder Dust (K&D Session), 3
John Cameron - Swamp Fever, 4
The Specials - A Message To You Rudy, 3
Dusty Springfield - Spooky, 2
Thievery Corporation - Focus On Sight, 3
Greyboy - The Real, 0
A Tribe Called Quest - Electric Relaxation (Instrumental), 4
Carolyn Franklin - Deal With It, 4
Charles Bradley - No Time For Dreaming, 2
The Herbaliser - Battle of Bongo Hill, 3
Billy Brooks - Forty Days, 3
The J.B.'s - Gimme Some More, 3
A Tribe Called Quest - Luck Of Lucien (Instrumental), 4
James Brown - Soul Power, 3
Eddie Bo - Check Your Bucket (Parts 1 & 2), 2
Ini Kamoze - Here Comes The Hotstepper, 0
