Billy Wade & The 3 Degrees - Tear It Up (Part 2), 0
Booker T & The MG's - Time Is Tight, 0
Cymande - The Message, 0
Cypress Hill - Yo Quiero Fumar, 0
Gal Costa & Caetano Veloso - Remelexo, 0
Gwen McCrae - 90% Of Me Is You, 0
Howard Roberts - Dirty Old Bossa Nova, 0
Joăo Gilberto - De Conversa Em Conversa, 0
Jorge Ben - País Tropical, 0
Jorge Ben - Take It Easy My Brother Charles, 0
Massive Attack - Teardrop, 0
RJD2 - Work, 0
Sylvia Telles - Samba De Uma Nota So, 0
Betty Harris - Break In The Road (feat. The Meters), 2
Betty Wright - Clean Up Woman, 2
Blackalicious - Deep In The Jungle (Instrumental), 2
Handsome Boy Modeling School - The Truth (feat. Roisin Murphy & J-Live), 2
Joe Dukie & DJ Fitchie - Midnight Marauders, 2
Jorge Ben - Por Causa de Voce Menina, 2
Sharon Jones & The Dap Kings - Make It Good To Me, 2
Sister Nancy - Bam Bam, 2
Aaron Neville - Hercules, 5
Bill Withers - Use Me, 3
Gloria Jones - Tainted Love, 3
Jeru The Damaja - Me Or The Papes (Instrumental), 3
Joe Dukie & DJ Fitchie - This Room, 2
Marcia Aitken - I'm Still In Love, 3
Nightmares On Wax - Morse, 3
Sharon Jones And The Dap Kings - Make It Good To Me, 3
Slickers - Johnny Too Bad, 3
Tenor Saw - Ring The Alarm, 3
The Diplomats Of Solid Sound - Smokey Places, 3
The Quantic Soul Orchestra - End Of The Road (feat. Alice Russell), 3
Tommy Mccook - Green Mango, 3
Toots & The Maytals - 54, 3
Various - Tenor Saw - Ring The Alarm, 3
The  Dynamics - Whole Lotta Love, 4
Greyboy - Parkside Bounce, 3
Frank Pleyer - Sally, 3
Stan Getz & Astrud Gilberto - One Note Samba (Live), 2
Dorothy Ashby - Come Live with Me, 3
Pharrell Williams - Happy, 0
King Tubby - The Battle Axe Dub, 4
Prince Fatty - Milk and Honey In My Dub, 3
The Gaturs - The Booger Man, 3
Jimmy Cliff - Ruby Soho, 5
Dionne Warwick - Do You Know The Way To San Jose, 2
Pharrell Williams - Happy (Cousin Cole Reggae Mix), 3
The Skatalites - Swing Easy, 2
Lennie Hibbert - Real Hot (RB Edit), 4
Augustus Pablo & King Tubby - King Tubby's Borderline Dub, 4
