Barry White - Satin Soul, 0
Beastie Boys - Shake Your Rump (Instrumental), 0
Breakestra - Sexy Coffe Pot, 0
Brentford Allstars - Greedy G, 0
De La Soul - 4 More (feat. Zhane), 0
De La Soul - Ring Ring Ring (Ha Ha Hey), 0
Dusty Springfield - Spooky, 0
Jurassic 5 - React (Instrumental), 0
Otis Redding - (Sittin' On) The Dock Of The Bay, 0
People Under The Stairs - Anotha' (BBQ), 0
Sharon Jones & The Dap Kings - Trimmed, 0
The Beatnuts - Off The Books (Instrumental), 0
The Beatnuts - Watch Out Now (Instrumental), 0
The Emotions - I Like It, 0
The Specials - A Message To You Rudy, 0
Tony Alvon & The Belairs - Sexy Coffee Pot, 0
Vanessa da Mata - Não Me Deixe Só, 0
Aretha Franklin - Think, 2
Dandy Livingstone - Rudy, A Message To You, 2
Dizzy Gillespie - Matrix, 2
Greyboy - Panacea, 2
Marilyn Barbarin - Reborn, 2
Speedometer - Answer To Mother Popcorn (Live), 2
The Diplomats Of Solid Sound - Hurt Me So, 2
Tosca - Honey, 2
Gilberto Gil - Roda, 3
Jurassic 5 - Improvise (Instrumental), 3
Mr. Scruff - Champagne Nibbler, 3
Speedometer - Accra International Airport, 3
Cymande - Brothers On The Slide, 4
The Bamboos - Red Triangle, 4
Tim Maia - No Caminho Do Bem, 4
