Tommy Mccook - Green Mango, 5
Dub Specialist - Dub It Easy, 4
King Jammy - Slow Motion Dub, 2
Ramsey Lewis Trio - Slippin' Into Darkness, 2
Jimmy McGriff - Blue Juice, 0
Lee 'Scratch' Perry and King Tubby - MFA Dub, 2
Astrud Gilberto - Canto De Ossanha (Let Go), 2
Jorge Ben - Criola, 3
Tenor Saw - Ring The Alarm, 3
John Holt - Man Next Door (Got To Get Away), 2
Beastie Boys - Some Dumb Cop Gave Me Two Tickets Already (Instrumental), 2
Chino - Jade Sunrise, 0
Stan Getz & Charlie Byrd - Desafinado, 0
Dusty Springfield - Willie & Laura Mae Jones, 2
Charles Bradley And The Menahan Street Band - The World (Is Going Up In Flames), 2
Charles Bradley - The World (Is Going Up In Flames), 2
Dizzy Gillespie - In A Shanty In Old Shanty Town, 2
Eddie Henderson - Inside You, 4
Wes Montgomery - Summertime, 2
Beastie Boys - Transitions, 0
Cal Tjader - Pantano, 0
Elzhi & Will Sessions - Memory Lane (Instrumental), 2
Mr. Scruff - Jusjus (feat. Roots Manuva), 0
Jack McDuff - Hunk O'funk, 3
Donald Byrd - Weasil, 0
The New Mastersounds - The Vandenburg Suite, 0
Stan Getz & Astrud Gilberto - One Note Samba (Live), 2
Betty Wright - Clean Up Woman, 2
The 3 Sounds - Put on Train, 4
Jorge Ben - Mas Que Nada, 3
People Under The Stairs - The Breakdown, 4
Jurassic 5 - Quality Control, 4
Sergio Mendes & Brasil 66 - Mas Que Nada, 2
Al Brown - Here I Am Baby, 3
Jurassic 5 - If You Only Knew (Instrumental), 4
Elza Soares - Chove Chuva, 0
Jurassic 5 - Concrete Schoolyard, 2
Jurassic 5 - Concrete Schoolyard (Instrumental), 3
Thievery Corporation - All That We Perceive, 2
Pete Rock - A Little Soul, 3
The Gaylettes - Son Of A Preacher Man, 4
