Taggy Matcher - Witness, 3
Ian Pooley - Spicy Snapper, 2
A Tribe Called Quest - Can I Kick It, 3
Jorge Ben - Cadê Tereza, 2
People Under The Stairs - Flex Off, 0
Baby Huey & The Baby Sitters - Hard Times, 0
Thievery Corporation - Lebanese Blonde (French), 2
Betty And Angel - Honey Coated Loving, 0
Spanky Wilson & The Quantic Soul Orchestra - I'm Thankful (Part 1), 2
Average White Band - Stop The Rain, 4
Al Green - Let's Stay Together, 0
Jorge Ben - Rosa, Menina Rosa, 0
De La Soul - All Good? (feat. Chaka Khan), 3
Ernest Ranglin - Love and Happiness, 2
Charles Bradley - No Time For Dreaming, 0
Ty - Don't Watch That (Grant Phabao Remix), 2
Mr. Scruff - Here We Go, 3
King Jammy - Dub It in the Dancehall Dub, 3
Sharon Jones & The Dap Kings - Be Easy, 3
Bob Marley - Run For Cover, 2
The J.B.'s - Gimme Some More, 2
Sharon Jones & The Dap Kings - You Better Think Twice, 2
Nas - Halftime (Instrumental), 4
Astrud Gilberto - Take It Easy, My Brother Charlie, 2
Quannum Projects - I Changed My Mind (Instrumental), 4
Tosca - Chocolate Elvis (Boozoo Bajou Version), 2
Bomb The Bass - Bug Powder Dust (K&D Session), 0
Eddie Bo - Check Your Bucket, 2
The Specials - A Message To You Rudy, 0
Lou Donaldson - Ode To Billy Joe, 0
Madlib - Montara, 4
DJ Nu Mark - Comin' Thru (feat. Chali 2na) (Instrumental) (RB Edit), 2
People Under The Stairs - The L.A. Song, 2
Djavan - Serrado, 2
