Kool & The Gang - Summer Madness, 2
Dom Salvador E Abolicao - Hei Voce, 3
Sylvia Telles - Samba De Uma Nota So, 2
Howard Roberts - Dirty Old Bossa Nova, 2
Stan Getz & Astrud Gilberto - One Note Samba (Live), 3
Greyboy - Parkside Bounce, 4
Roy Ayers - Everybody Loves The Sunshine, 2
Stan Getz & Charlie Byrd - Desafinado, 2
Frank Pleyer - Sally, 2
Dizzy Gillespie - In A Shanty In Old Shanty Town, 0
Ramsey Lewis Trio - Slippin' Into Darkness, 2
Jorge Ben - Take It Easy My Brother Charles, 0
Sister Nancy - Bam Bam, 3
RJD2 - Work, 2
Ernest Ranglin - Satta Massagana, 3
Eddie Henderson - Inside You, 2
The Gaturs - The Booger Man, 2
Gwen McCrae - 90% Of Me Is You, 3
The  Dynamics - Whole Lotta Love, 4
Sharon Jones & The Dap Kings - Make It Good To Me, 3
Nightmares On Wax - Morse, 4
Betty Wright - Clean Up Woman, 2
Betty Harris - Break In The Road (feat. The Meters), 3
Slickers - Johnny Too Bad, 3
Cymande - The Message, 3
Jeru The Damaja - Me Or The Papes (Instrumental), 4
Toots & The Maytals - 54, 4
Tommy Mccook - Green Mango, 4
Jorge Ben - O Namorado Da Viúva, 2
Joe Dukie & DJ Fitchie - Midnight Marauders, 2
Jorge Ben - País Tropical, 2
Aaron Neville - Hercules, 3
John Holt - Man Next Door (Got To Get Away), 2
Handsome Boy Modeling School - The Truth (feat. Roisin Murphy & J-Live), 4
The Chosen Few - I Love The Way You Love, 3
The Skatalites - Swing Easy, 4
Greyboy - Grey Royale, 5
Freesom Orquestra - Rush, 5
Jimmy Cliff - Ruby Soho, 0
The Gaylettes - Son Of A Preacher Man, 2
