Betty Wright - Clean Up Woman, 0
Charles Bradley And The Menahan Street Band - The World (Is Going Up In Flames), 0
Horace Andy - I Feel Good All Over, 0
Jeru The Damaja - Me Or The Papes (Instrumental), 0
Sergio Mendes & Brasil 66 - Mas Que Nada, 0
The Chosen Few - I Love The Way You Love, 0
De La Soul - Fallin' (feat. Teenage Fan Club), 2
Group Home - Intro (Instrumental), 2
Sly & Robbie - Asian Roots Dub, 2
Cymande - The Message, 3
Lee 'Scratch' Perry and King Tubby - MFA Dub, 3
People Under The Stairs - The Breakdown, 3
Erykah Badu - Honey (Grant Phabao Remix), 0
Sublime - Badfish, 0
Ernest Ranglin - 54-46 (Was My Number), 0
Sylvia Telles - Samba De Uma Nota So, 3
Kool & The Gang - Summer Madness, 3
The Meters - Handclapping Song, 2
The New Mastersounds - Can't Hold Me Down, 3
The New Mastersounds - Forgiveness, 3
The Gaturs - The Booger Man, 2
The Three Degrees - You're The Fool, 0
Elzhi & Will Sessions - Memory Lane (Instrumental), 3
Baby Huey & The Baby Sitters - Hard Times, 3
Betty And Angel - Honey Coated Loving, 2
Freesom Orquestra - Rush, 2
Fela Soul - Trouble In The Water (Instrumental), 3
Nightmares On Wax - Les Nuits (DJ Spinna Mix), 3
Wes Montgomery - Tequila, 4
Taggy Matcher - Ain't Hard To Tell, 2
