Betty Wright - Is It You Girl, 0
Charles Bradley And The Menahan Street Band - The World (Is Going Up In Flames), 0
Chic - Good Times, 0
De La Soul - Keepin' The Faith, 0
Elzhi & Will Sessions - The World Is Yours (Instrumental), 0
Hannibal - Somebody In This World, 0
James Brown - Say It Loud I'm Black And I'm Proud, 0
Jorge Ben - Mas Que Nada, 0
Jorge Ben - Take It Easy My Brother Charles, 0
Jurassic 5 - A Day At The Races (feat. Big Da), 0
RZA - You Can't Stop Me Now, 0
Sylvia Telles - Samba De Uma Nota So, 0
The New Mastersounds - Dusty Groove, 0
The Sugarhill Gang - Rapper's Delight, 0
Tosca - Dave Dudley, 0
Wess & The Airedales - Blackout, 0
Betty Harris - Break In The Road (feat. The Meters), 2
Tim Maia - No Caminho Do Bem, 0
Elza Soares - Chove Chuva, 0
Group Home - Intro (Instrumental), 2
Cymande - The Message, 3
Evinha - Que Bandeira, 3
The 3 Sounds - Put on Train, 4
Al Brown - Here I Am Baby, 3
Mr. Scruff - Jusjus (feat. Roots Manuva), 5
Shapeshifter - Electric Dream, 2
Nightmares On Wax - Ethnic Majority, 2
Tenor Saw - Ring The Alarm, 3
John Holt - Man Next Door (Got To Get Away), 4
Naughty By Nature - Feel Me Flow (Instrumental), 3
Nightmares On Wax - 195lbs, 3
Aretha Franklin - One Step Ahead (Ms. Fat Booty Blend), 3
RJD2 - 2 More Dead, 2
DJ Marky & XRS - LK (Instrumental), 0
Sister Nancy - Bam Bam, 2
Arrested Development - People Everyday (Instrumental) (RB Edit), 4
Cypress Hill - Yo Quiero Fumar, 2
