Pharrell Williams - Happy, 4
Stan Getz & Astrud Gilberto - One Note Samba (Live), 3
Stan Getz & Charlie Byrd - Desafinado, 0
Howard Roberts - Dirty Old Bossa Nova, 2
Tamba Trio - Mas Que Nada, 3
João Gilberto - Brigas, Nunca Mais, 0
Gal Costa & Caetano Veloso - Remelexo, 0
Sylvia Telles - Samba De Uma Nota So, 2
King Tubby - Black Lash, 3
King Tubby - The Battle Axe Dub, 4
The  Dynamics - Whole Lotta Love, 4
Nightmares On Wax - Morse, 3
Betty Harris - Break In The Road (feat. The Meters), 3
RJD2 - Work, 0
Marcia Aitken - I'm Still In Love, 4
Toots & The Maytals - 54, 3
The Gaturs - The Booger Man, 0
Aaron Neville - Hercules, 3
The 3 Sounds - Repeat After Me, 0
Sister Nancy - Bam Bam, 2
Ernest Ranglin - Satta Massagana, 2
Sharon Jones & The Dap Kings - Make It Good To Me, 0
Bill Withers - Use Me, 3
Slickers - Johnny Too Bad, 3
The Quantic Soul Orchestra - End Of The Road (feat. Alice Russell), 2
Glen Brown and King Tubby - Lambs Bread Dubwise, 2
Booker T & The MG's - Time Is Tight, 0
Augustus Pablo & King Tubby - King Tubby's Borderline Dub, 0
Althea & Donna - Uptown Top Ranking, 3
Frank Pleyer - Sally, 0
Sharon Jones & The Dap Kings - People Don't Get What They Deserve, 3
Dorothy Ashby - Come Live with Me, 2
The Chosen Few - I Love The Way You Love, 3
Erykah Badu - Honey (Grant Phabao Remix), 3
Roni Size & Reprazent - Brown Paper (Roni Size Full Rap Remix), 0
