Betty Harris - Break In The Road (feat. The Meters), 0
Bill Withers - Use Me, 0
Booker T & The MG's - Time Is Tight, 0
Elis Regina - Acuas de Marco, 0
Gloria Jones - Tainted Love, 0
Gwen McCrae - 90% Of Me Is You, 0
Joe Dukie & DJ Fitchie - Midnight Marauders, 0
Jorge Ben - Quero Esquecer Voce, 0
Massive Attack - Teardrop, 0
The Bamboos - Like Tears In Rain, 0
Toots & The Maytals - 54, 0
Althea & Donna - Uptown Top Ranking, 2
Blackalicious - Deep In The Jungle (Instrumental), 2
Gal Costa & Caetano Veloso - Maria Joana, 2
Gal Costa & Caetano Veloso - Remelexo, 2
Joăo Gilberto - De Conversa Em Conversa, 2
Marcia Aitken - I'm Still In Love, 2
Slickers - Johnny Too Bad, 2
Handsome Boy Modeling School - The Truth (feat. Roisin Murphy & J-Live), 3
Joe Dukie & DJ Fitchie - This Room, 3
Nightmares On Wax - Morse, 3
The Maytals - Night and Day, 3
The Quantic Soul Orchestra - End Of The Road (feat. Alice Russell), 3
Howard Roberts - Dirty Old Bossa Nova, 4
The 3 Sounds - Repeat After Me, 2
Frank Pleyer - Sally, 0
Roy Ayers - Everybody Loves The Sunshine, 0
Greyboy - Parkside Bounce, 4
The Skatalites - Swing Easy, 5
Stan Getz & Astrud Gilberto - One Note Samba (Live), 4
El Michels Affair - Walk On By, 0
Jorge Ben - Menina Bonita Nao Chora, 2
Augustus Pablo & King Tubby - King Tubby's Borderline Dub, 0
Aaron Neville - Hercules, 2
Pharrell Williams - Happy, 3
Prince Fatty - Milk and Honey In My Dub, 3
Dionne Warwick - Do You Know The Way To San Jose, 3
Pharrell Williams - Happy (Cousin Cole Reggae Mix), 2
Jorge Ben - Carolina Carol Bela (Com Toquinho), 2
Jimmy Cliff - Ruby Soho, 2
Lennie Hibbert - Real Hot (RB Edit), 3
