Aaron Neville - Hercules, 0
Althea & Donna - Uptown Top Ranking, 0
Booker T & The MG's - Time Is Tight, 0
Elis Regina - Acuas de Marco, 0
Joe Dukie & DJ Fitchie - Midnight Marauders, 0
Jorge Ben - Quero Esquecer Voce, 0
Marcia Aitken - I'm Still In Love, 0
Billy Wade & The 3 Degrees - Tear It Up (Part 2), 2
Gal Costa & Caetano Veloso - Remelexo, 2
Gwen McCrae - 90% Of Me Is You, 2
João Gilberto - Brigas,       Nunca Mais, 2
Joăo Gilberto - De Conversa Em Conversa, 2
Jorge Ben - País Tropical, 2
Nightmares On Wax - Morse, 2
Sister Nancy - Bam Bam, 2
The Quantic Soul Orchestra - End Of The Road (feat. Alice Russell), 2
Blackalicious - Deep In The Jungle (Instrumental), 3
Cypress Hill - Yo Quiero Fumar, 3
Howard Roberts - Dirty Old Bossa Nova, 3
Lee Fields And Sugarman And Co. - Stand Up, 3
Slickers - Johnny Too Bad, 3
Sylvia Telles - Samba De Uma Nota So, 3
The  Dynamics - Whole Lotta Love, 3
Tommy Mccook - Green Mango, 3
Gloria Jones - Tainted Love, 4
Greyboy - Parkside Bounce, 2
Stan Getz & Astrud Gilberto - One Note Samba (Live), 2
Dom Salvador E Abolicao - Hei Voce, 2
Jorge Ben - Take It Easy My Brother Charles, 3
Stan Getz & Charlie Byrd - Desafinado, 2
Tenor Saw - Ring The Alarm, 3
Jeru The Damaja - Me Or The Papes (Instrumental), 3
Inner Circle - Bad Reputation, 3
