Beastie Boys - Shake Your Rump (Instrumental), 0
ConFunkShun - Clique, 0
De La Soul - 4 More (feat. Zhane), 0
De La Soul - Ring Ring Ring (Ha Ha Hey), 0
Dusty Springfield - Spooky, 0
Explosions - Garden Of Four Trees, 0
Gilberto Gil - Roda, 0
Grandmaster Flash - The Message (Instrumental), 0
Jackie Mittoo - Stereo Freeze, 0
James Knight And The Butlers - Save Me, 0
Otis Redding - (Sittin' On) The Dock Of The Bay, 0
RJD2 - All For U, 0
The Specials - A Message To You Rudy, 0
Tim Armstrong - Wake Up, 0
Tony Alvon & The Belairs - Sexy Coffee Pot, 0
Vanessa da Mata - Não Me Deixe Só, 0
A Tribe Called Quest - Electric Relaxation (Instrumental), 2
Aretha Franklin - Rock Steady, 2
Aretha Franklin - Think, 2
Dizzy Gillespie - Matrix, 2
People Under The Stairs - Anotha' (BBQ), 2
Sharon Jones & The Dap Kings - How Long Do I Have To Wait, 2
Spanky Wilson - Kissing My Love, 2
The Beatnuts - Fluid, 2
The Budos Band - Up From The South, 2
Sharon Jones & The Dap Kings - How Long Do I Have To Wait For You?, 3
The Beatnuts - Watch Out Now (Instrumental), 3
Tosca - Honey, 2
The Vibrette - Humpty Dump, 4
James Brown - Don't Tell It, 3
The J.B.'s - Hot Pants Road, 3
Jurassic 5 - Break (Instrumental), 3
A Tribe Called Quest - Luck Of Lucien (Instrumental), 3
Bill Withers - The Same Love That Made Me Laugh, 2
Willie Bobo & The Bo Gents - Broasted Or Fried, 3
Al Green - Love And Happiness, 3
Sharon Jones & The Dap Kings - Pick It Up, Lay It In The Cut, 2
James Brown - Funky Drummer, 0
Jurassic 5 - How We Get Along (Instrumental), 3
The J.B.'s - Pass The Peas, 2
Sola Rosa - Del Ray, 3
Thievery Corporation - Focus On Sight, 2
Inell Young - What Do You See In Her, 3
Elis Regina - Menino Das Laranjas, 2
Ernest Ranglin - Love and Happiness, 2
Free Som Orchestra - The Kings Bounce, 2
The Bamboos - The Ghost, 3
Barry White - Satin Soul, 3
Deltron 3030 - Positive Contact, 2
Quannum Projects - I Changed My Mind (Instrumental), 3
Bomb The Bass - Bug Powder Dust (K&D Session), 0
Prince Fatty - Insane In The Brain (feat. Horseman), 3
Sharon Jones And The Dap Kings - How Long Do I Have To Wait, 2
Damu the Fudgemunk - Fabrega's Discotecas, 4
Deadbeats - Pick Me Up (Nightmares On Wax Edit), 4
Donald Byrd - (Fallin' Like) Dominoes, 4
Blackalicious - Rock The Spot (Instrumental), 2
King Tubby - Rock With I Dub, 3
Fela Soul - Still Ego Trippin' (Instrumental), 2
