Aloe Blacc - I Need A Dollar (Instrumental), 2
Greyboy - Texas Twister, 2
Average White Band - Stop The Rain, 4
Gilberto Gil - Mancada, 3
Tosca - Worksong, 4
Bomb The Bass - Bug Powder Dust (K&D Session), 2
Lyn Collins - Give It Up Or Turn It Loose, 3
James Brown - Blues & Pants, 3
Prince Fatty - Insane In The Brain (feat. Horseman), 4
Nightmares On Wax - Play On, 4
Al Green - Here I Am (Come And Take Me), 4
Nas - One Love (Large Professor Remix) (Instrumental), 3
Sharon Jones And The Dap Kings - I'm Not Gonna Cry, 5
Eddie Bo - Funky Jam, 3
Jurassic 5 - Unified Rebelution, 4
El Michels Affair - C.R.E.A.M., 2
Bill Withers - Lovely Day, 4
Joe Dukie & DJ Fitchie - Seconds Vocal, 3
The Bamboos - The Ghost, 4
Taggy Matcher - Root Down, 3
Tim Armstrong - Hold On, 3
Jurassic 5 - How We Get Along (Instrumental), 3
James Knight And The Butlers - Save Me, 0
Beastie Boys - Hey Ladies (Instrumental), 4
Charles Wright & The Watts 103rd Street Rhythm Band - Express Yourself, 2
A Tribe Called Quest - Electric Relaxation (Instrumental), 0
Sublime - Badfish, 2
Edson Frederico - Bobeira, 3
Cypress Hill - Latin Thugs (Instrumental), 3
Ini Kamoze - Here Comes The Hotstepper, 4
