Archie Bell & The Drells - Tighten Up, 0
Betty Wright - Shoorah! Shoorah!, 0
Jackie Mittoo And The Soul Brothers - James Bond Theme, 0
Nina Simone - Ain't Got No; I Got Life (Alternate), 0
Rockers Hi Fi - Transmission Central, 0
Sharon Jones & The Dap Kings - How Do You Let A Good Man Down?, 0
Young MC - Pick Up The Pace (1990 Version), 0
Curtis Mayfield - Pusherman, 2
Dee Lite - Groove Is In The Heart, 2
Ian Pooley - Menino Brincadeira, 2
Mr. Scruff - Get a Move On, 2
Spanky Wilson & The Quantic Soul Orchestra - Don't Joke With A Hungry Man (Part 2), 2
Spanky Wilson & The Quantic Soul Orchestra - Don't Joke With A Hungry Man (Part 3), 2
The Bamboos - Tighten It Up, 2
The Pioneers - Papa Was A Rolling Stone, 2
Tosca - Honey (Faze Action Dub), 2
Aretha Franklin - Save Me, 3
Jackie Mittoo - Juice Box, 4
Little Roy - Lithium, 3
Los Tios Queridos - Si Me Ves Volar, 3
Nina Simone - Save Me, 3
Speedometer - Up the Down, 3
The Skatalites - Chinatown, 4
Spanky Wilson - Sunshine Of Your Love, 5
James Brown - I Can't Stand Myself (When You Touch Me) (Part 1), 3
The Quantic Soul Orchestra - Hold it Down, 2
Stan Getz & Charlie Byrd - E Luxo So, 0
Richard "Groove" Holmes - Grooving With Mr. G, 3
Ann Sexton - You've Been Gone To Long, 3
Marva Whitney - Things Have Got To Get Better, 3
Spiller - Groovejet (Radio Edit) (Instrumental), 4
De La Soul - The Magic Number, 3
Ernest Ranglin - Ball Of Fire, 0
Thievery Corporation - Shadows Of Ourselves, 4
Jackie Mittoo And The Soul Brothers - James Bond, 0
The HitchHikers - Mr Fortune, 0
Placebo - Only Nineteen, 2
Roberta Roena - Que Se Sepa, 3
Orlandivo - E Samba, 2
Bobby Hebb - Sunny, 3
Moloko - The Time Is Now (Can 7 Remix), 3
Señor Coconut - Around The Wold (Intro), 3
