Stan Getz & Astrud Gilberto - Corcovado (Quiet Nights Of Quiet Stars) (Live), 0
Donald Byrd - Love's so Far Away, 2
The Casualties of Jazz - Into The Void, 2
Astrud Gilberto - Brazilian Tapestry, 3
Lou Donaldson - Turtle Walk, 3
Placebo - Only Nineteen, 3
Stan Getz & Charlie Byrd - E Luxo So, 3
Grant Green - Sookie, Sookie, 4
Speedometer - Time for Change, 4
The New Mastersounds - Beyond The Bleak Horizon, 2
Richard "Groove" Holmes - Grooving With Mr. G, 2
James Brown - I Can't Stand Myself (When You Touch Me) (Part 1), 0
Al Green - Standing In The Rain, 2
Betty Harris - Ride Your Pony, 3
Spanky Wilson - Sunshine Of Your Love, 3
The Quantic Soul Orchestra - Hold it Down, 2
Nina Simone - Save Me, 3
The Budos Band - Budos Rising, 3
Tosca - Damentag, 0
Jackie Mittoo And The Soul Brothers - James Bond Theme, 3
Deltron 3030 - Talent Supercedes (feat. Black Rob), 3
Spanky Wilson & The Quantic Soul Orchestra - Don't Joke With A Hungry Man (Part 3), 4
Rockers Hi Fi - Transmission Central, 3
The Pioneers - Papa Was A Rolling Stone, 2
Marva Whitney - Things Have Got To Get Better, 3
Ann Sexton - You've Been Gone To Long, 2
Jackie Mittoo - Juice Box, 2
The Skatalites - Confucious (RB Edit), 3
Spiller - Groovejet (Radio Edit) (Instrumental), 4
Betty Wright - Shoorah! Shoorah!, 4
Jackie Mittoo And The Soul Brothers - James Bond, 3
Jungle Fire - Comencemos (Let's Start), 2
The HitchHikers - Mr Fortune, 3
Cal Tjader - Tanya, 2
The Bamboos - The Witch, 4
El Michels Affair - Uzi (Pinky Ring), 3
Mr. Scruff - Get a Move On, 2
DJ Leacy - Theme From Cloud, 0
Tosca - Honey (Faze Action Dub), 2
Bobby Hebb - Sunny, 2
