Greyboy - Panacea, 0
Average White Band - Pick Up The Pieces, 2
Cannonball Adderley - Minha Saudades, 2
Dizzy Gillespie - Matrix, 2
Elis Regina - Menino Das Laranjas, 2
Jurassic 5 - Improvise (Instrumental), 2
Otis Redding - (Sittin' On) The Dock Of The Bay, 2
The Bamboos - Red Triangle, 2
The Emotions - I Like It, 2
The New Mastersounds - 102 Per Cent, 2
The Quantic Soul Orchestra - Pushin' On (feat. Alice Russell), 2
The Soul Machine - Twitchie Feet, 2
Thievery Corporation - Focus On Sight, 2
Beastie Boys - Hey Ladies (Instrumental), 3
Gilberto Gil - Roda, 3
James Brown - Get On The Good Foot, 3
James Brown - Soul Power, 3
Mr. Scruff - Champagne Nibbler, 2
Breakestra - Sad Chicken, 4
Deadbeats - Pick Me Up (Nightmares On Wax Edit), 4
Deltron 3030 - Positive Contact, 2
Sharon Jones & The Dap Kings - How Long Do I Have To Wait For You?, 4
Sharon Jones & The Dap Kings - How Long Do I Have To Wait, 4
The Dap Kings - Nervous Like Me, 2
Sharon Jones & The Dap Kings - Tell Me, 3
Sharon Jones & The Dap Kings - Hook And Sling Meets The Funky Superfly, 2
Sharon Jones & The Dap Kings - Something's Changed, 2
Sharon Jones & The Dap Kings - Pick It Up, Lay It In The Cut, 2
Sharon Jones & The Dap Kings - You Better Think Twice, 3
Jungle Fire - Comencemos (Let's Start), 4
A Tribe Called Quest - Youthful Expression (Instrumental), 3
Tosca - Honey, 3
