Althea & Donna - Uptown Top Ranking, 0
Betty Wright - Clean Up Woman, 0
Billy Wade & The 3 Degrees - Tear It Up (Part 2), 0
Cypress Hill - Yo Quiero Fumar, 0
Gloria Jones - Tainted Love, 0
Gwen McCrae - 90% Of Me Is You, 0
Howard Roberts - Dirty Old Bossa Nova, 0
Jorge Ben - País Tropical, 0
Jorge Ben - Take It Easy My Brother Charles, 0
Sharon Jones And The Dap Kings - Make It Good To Me, 0
Slickers - Johnny Too Bad, 0
Sylvia Telles - Samba De Uma Nota So, 0
Aaron Neville - Hercules, 2
Betty Harris - Break In The Road (feat. The Meters), 2
Dusty Springfield - Willie & Laura Mae Jones, 2
Elzhi & Will Sessions - The World Is Yours (Instrumental), 2
Gal Costa & Caetano Veloso - Remelexo, 2
João Gilberto - Brigas, Nunca Mais, 2
Sister Nancy - Bam Bam, 2
The  Dynamics - Whole Lotta Love, 2
RJD2 - Work, 3
Tenor Saw - Ring The Alarm, 3
Tommy Mccook - Green Mango, 3
Cymande - The Message, 4
Lee Fields And Sugarman And Co. - Stand Up, 4
People Under The Stairs - The Breakdown, 4
The Diplomats Of Solid Sound - Smokey Places, 4
Stan Getz & Astrud Gilberto - One Note Samba (Live), 2
Beastie Boys - Groove Holmes, 0
Frank Pleyer - Sally, 0
Dorothy Ashby - Come Live with Me, 5
Dom Salvador E Abolicao - Hei Voce, 5
Jorge Ben - O Namorado Da Viúva, 2
Jeru The Damaja - Me Or The Papes (Instrumental), 3
Sharon Jones & The Dap Kings - People Don't Get What They Deserve, 3
Sharon Jones & The Dap Kings - Be Easy, 2
The Gaturs - The Booger Man, 3
Ernest Ranglin - Satta Massagana, 2
The Chosen Few - I Love The Way You Love, 3
Jimmy Cliff - Ruby Soho, 2
Freesom Orquestra - Rush, 5
The Gaylettes - Son Of A Preacher Man, 3
