Aloe Blacc - Good Things, 0
Aretha Franklin - One Step Ahead (Ms. Fat Booty Blend), 0
Baby Huey & The Baby Sitters - Hard Times, 0
Bob Marley - Run For Cover, 0
Charles Wright & The Watts 103rd Street Rhythm Band - Express Yourself, 0
Ernest Ranglin - Love and Happiness, 0
Evinha - Que Bandeira, 0
Greyboy - Lite Bake, 0
Jorge Ben - Balanca Pema, 0
Jurassic 5 - Freedom (Instrumental), 0
Jurassic 5 - Lausd (Instrumental), 0
Katchafire - Get Away, 0
Nas - Halftime (Instrumental), 0
Nightmares On Wax - The Sweetest, 0
People Under The Stairs - Acid Raindrops, 0
Sharon Jones & The Dap Kings - Better Things (Instrumental), 0
The Beatnuts - Get Funky (Instrumental), 0
The New Mastersounds - Can't Hold Me Down, 0
The Pharcyde - Runnin, 0
Thievery Corporation - Lebanese Blonde (French), 0
Tosca - Chocolate Elvis, 0
Young MC - Principal's Office (Instrumental), 0
A Tribe Called Quest - 1nce Again (Instrumental), 2
Depeche Mode - Useless (K&D Session), 2
The Three Degrees - You're The Fool, 2
A Tribe Called Quest - Jam, 3
A Tribe Called Quest - Oh My God, 3
Ann Allford - Gotta Get Me A Job, 3
Betty And Angel - Honey Coated Loving, 3
Nas - One Love (Large Professor Remix) (Instrumental), 3
Pete Rock - Back On The Block (Instrumental), 3
Al Green - Here I Am (Come And Take Me), 4
DJ Nu Mark - Comin' Thru (feat. Chali 2na) (Instrumental) (RB Edit), 2
Barry White - It's Only Love Doing It's Thing, 0
Ty - Don't Watch That (Grant Phabao Remix), 3
