A Tribe Called Quest - Jam, 0
A Tribe Called Quest - Oh My God, 0
Ann Allford - Gotta Get Me A Job, 0
Aretha Franklin - One Step Ahead (Ms. Fat Booty Blend), 0
Charles Wright & The Watts 103rd Street Rhythm Band - Express Yourself, 0
DJ Jazzy Jeff And The Fresh Prince - Summertime (Instrumental), 0
Ernest Ranglin - Love and Happiness, 0
Jackie Mittoo - Get Up And Get It, 0
Jurassic 5 - Lausd (Instrumental), 0
The Beatnuts - Get Funky (Instrumental), 0
Thievery Corporation - Lebanese Blonde (French), 0
Agora Chega - Super Som T.A., 2
Bob Marley - Run For Cover, 2
Nightmares On Wax - The Sweetest, 2
Spanky Wilson & The Quantic Soul Orchestra - I'm Thankful (Part 1), 2
The Pharcyde - Runnin, 2
Young MC - Principal's Office (Instrumental), 2
El Michels Affair - Red Rooster, 0
James Brown - The Payback, 3
Jurassic 5 - Great Expectations (Instrumental), 4
Taggy Matcher - Ain't Hard To Tell, 0
Nas - One Love (Large Professor Remix) (Instrumental), 3
A Tribe Called Quest - 1nce Again (Instrumental), 2
Naughty By Nature - Feel Me Flow (Instrumental), 2
Nightmares On Wax - Keep On (feat. De La Soul) (86 Init Mix), 3
Gang Starr - You Know My Steez (Instrumental), 3
Erykah Badu - Soldier (Grant Phabao Remix), 3
Sublime - Badfish, 0
Cypress Hill - Latin Thugs (Instrumental), 2
Al Green - Here I Am (Come And Take Me), 2
DJ Muggs vs. Sick Jacken - El Barrio, 3
