Aretha Franklin - One Step Ahead (Ms. Fat Booty Blend), 0
Bob Marley - Run For Cover, 0
Charles Wright & The Watts 103rd Street Rhythm Band - Express Yourself, 0
Evinha - Que Bandeira, 0
Janet Jackson - Got 'Till It's Gone (feat. Q-Tip), 0
Jorge Ben - Criola, 0
Jorge Ben - Mas Que Nada, 0
Jurassic 5 - If You Only Knew (Instrumental), 0
Pete Rock - Back On The Block (Instrumental), 0
Pete Rock & CL Smooth - All The Places (Instrumental), 0
RZA - You Can't Stop Me Now, 0
Sergio Mendes & Brasil 66 - Mas Que Nada, 0
Sharon Jones & The Dap Kings - Be Easy, 0
Snoop Dogg - Vapors (Instrumental), 0
Thievery Corporation - Lebanese Blonde, 0
Common - Resurrection (Instrumental), 2
Nightmares On Wax - The Sweetest, 2
Spanky Wilson & The Quantic Soul Orchestra - That's How It Was, 2
Thievery Corporation - Lebanese Blonde (French), 2
A Tribe Called Quest - Jam, 4
Baby Huey & The Baby Sitters - Hard Times, 3
The New Mastersounds - Can't Hold Me Down, 3
Al Green - Let's Stay Together, 0
Jurassic 5 - Lausd (Instrumental), 3
DJ Nu-Mark - Lay 'Em Low (Instrumental), 0
Monty Alexander - Inner City Blues, 0
Naughty By Nature - Feel Me Flow (Instrumental), 0
Katchafire - Get Away, 3
Ty - Don't Watch That (Grant Phabao Remix), 3
Damu the Fudgemunk - Clap and Form Your Soul, 3
Jurassic 5 - Concrete Schoolyard (Instrumental), 2
Barry White - It's Only Love Doing It's Thing, 0
King Jammy - Dub It in the Dancehall Dub, 4
Elzhi & Will Sessions - Memory Lane (Instrumental), 2
Fela Soul - Oooh (Instrumental), 3
