Aaron Neville - Hercules, 0
De La Soul - Fallin' (feat. Teenage Fan Club), 0
João Gilberto - Brigas,  Nunca Mais, 0
João Gilberto - Brigas, Nunca Mais, 0
Jorge Ben - Take It Easy My Brother Charles, 0
Sergio Mendes & Brasil 66 - Mas Que Nada, 0
Tenor Saw - Ring The Alarm, 0
The  Dynamics - Whole Lotta Love, 0
Al Brown - Here I Am Baby, 2
Betty Harris - Break In The Road (feat. The Meters), 2
Cymande - The Message, 2
Dusty Springfield - Willie & Laura Mae Jones, 2
Jeru The Damaja - Me Or The Papes (Instrumental), 2
Sharon Jones And The Dap Kings - Make It Good To Me, 2
Sharon Jones & The Dap Kings - Make It Good To Me, 3
Stan Getz & Laurindo Almeida - Samba Da Sahra, 2
Dorothy Ashby - Come Live with Me, 4
The Gaturs - The Booger Man, 4
The Three Degrees - You're The Fool, 2
Monty Alexander - Inner City Blues, 2
Gal Costa & Caetano Veloso - Remelexo, 0
Stan Getz & Astrud Gilberto - One Note Samba (Live), 3
Erykah Badu - Honey (Grant Phabao Remix), 3
Charles Bradley And The Menahan Street Band - The World (Is Going Up In Flames), 0
Donald Byrd - Weasil, 0
Sylvia Telles - Samba De Uma Nota So, 2
Ramsey Lewis Trio - Slippin' Into Darkness, 0
Freesom Orquestra - Rush, 4
Jorge Ben - O Namorado Da Viúva, 2
Jimmy Cliff - Ruby Soho, 3
Sharon Jones & The Dap Kings - People Don't Get What They Deserve, 0
The Gaylettes - Son Of A Preacher Man, 3
Elzhi & Will Sessions - Memory Lane (Instrumental), 3
Sister Nancy - Bam Bam, 5
Ernest Ranglin - 54-46 (Was My Number), 4
Slickers - Johnny Too Bad, 3
John Holt - Man Next Door (Got To Get Away), 3
Bob Marley - Bend Down Low, 4
Fela Soul - Oooh (Instrumental), 0
Fela Soul - Trouble In The Water (Instrumental), 4
