Brentford Allstars - Greedy G, 0
Vanessa da Mata - Não Me Deixe Só, 0
Dandy Livingstone - Rudy, A Message To You, 2
Aretha Franklin - Rock Steady, 3
Barry White - Satin Soul, 3
Dusty Springfield - Spooky, 3
Gilberto Gil - Roda, 3
The Beatnuts - Watch Out Now (Instrumental), 3
Greyboy - Panacea, 5
Mr. Scruff - Champagne Nibbler, 4
A Tribe Called Quest - Luck Of Lucien, 4
Beastie Boys - Hey Ladies (Instrumental), 4
Donald Byrd - (Fallin' Like) Dominoes, 3
Explosions - Garden Of Four Trees, 3
James Brown - Get On The Good Foot, 4
Monie Love - It's A Shame, 4
A Tribe Called Quest - Luck Of Lucien (Instrumental), 2
Chic - Good Times, 4
Deltron 3030 - Positive Contact, 3
Billy Brooks - Forty Days, 4
Xanadu & Sweet Lady - Rapper´s Delight, 2
Prince Fatty - Insane In The Brain (feat. Horseman), 4
Jorge Ben - Pulo Pulo, 3
The Specials - A Message To You Rudy, 4
Carolyn Franklin - Deal With It, 3
Breakestra - Come On Over (feat. Afrodyete), 3
Cannonball Adderley - Minha Saudades, 3
El Michels Affair - Uzi (Pinky Ring), 4
Cymande - Brothers On The Slide, 2
The Herbaliser - Battle of Bongo Hill, 3
Thievery Corporation - Focus On Sight, 4
The New Mastersounds - Dusty Groove, 3
Otis Redding - (Sittin' On) The Dock Of The Bay, 3
Tim Maia - No Caminho Do Bem, 4
