A Tribe Called Quest - Clap Your Hands (Instrumental), 0
Ann Allford - Gotta Get Me A Job, 0
Bob Marley - Run For Cover, 0
Evinha - Que Bandeira, 0
Gilberto Gil - Mancada, 0
Janet Jackson - Got 'Till It's Gone (feat. Q-Tip), 0
Mr. Scruff - Music Takes Me Up (feat. Alice Russell), 0
Sergio Mendes & Brasil 66 - Mas Que Nada, 0
Sharon Jones & The Dap Kings - Natural Born Lover, 0
Spanky Wilson & The Quantic Soul Orchestra - I'm Thankful (Part 1), 0
The Pharcyde - Runnin, 0
The Soul Searcher - Ashley's Roachclip, 0
Thievery Corporation - Lebanese Blonde (French), 0
Tosca - Chocolate Elvis, 0
Tosca - Worksong, 0
Young MC - Principal's Office (Instrumental), 0
Charles Wright & The Watts 103rd Street Rhythm Band - Express Yourself, 2
Lena Mone - You Stay On My Mind, 2
A Tribe Called Quest - Jam, 3
Al Green - Let's Stay Together, 3
Cannonball Adderley - Groovy Sambas, 3
Clarence Wheeler & The Enforcers - Right On, 3
Ike & Tine Turner - Bold Soul Sister, 3
Jurassic 5 - Lausd, 3
Sharon Jones & The Dap Kings - Better Things To Do, 3
The Beatnuts - Get Funky (Instrumental), 3
Greyboy - Lite Bake, 2
John Cameron - Swamp Fever, 4
Banda Black Rio - Mr. Funky Samba, 4
Elzhi & Will Sessions - The World Is Yours (Instrumental), 2
