Archie Bell & The Drells - Tighten Up, 0
Aretha Franklin - Save Me, 0
Breakestra - Dark Clouds Rain Soul, 0
Ian Pooley - Menino Brincadeira, 0
Jackie Mittoo And The Soul Brothers - James Bond Theme, 0
James Brown - I Can't Stand Myself (When You Touch Me) (Part 1), 0
People Under The Stairs - The Grind, 0
Tosca - Honey (Faze Action Dub), 0
Young MC - Pick Up The Pace (1990 Version), 0
Curtis Mayfield - Superfly, 2
Elis Regina - Roda, 2
Groove Merchants - There's Got To Be Someone For Me, 2
Jackie Mittoo - Juice Box, 2
Little Roy - Lithium, 2
Mr. Scruff - Get a Move On, 2
Nina Simone - Save Me, 2
Sharon Jones & The Dap Kings - How Do You Let A Good Man Down?, 2
The Quantic Soul Orchestra - Hold it Down, 2
Dee Lite - Groove Is In The Heart, 3
Nina Simone - Ain't Got No; I Got Life (Alternate), 3
Spanky Wilson - Sunshine Of Your Love, 3
The Budos Band - Budos Rising, 3
Betty Wright - Shoorah! Shoorah!, 4
Los Tios Queridos - Si Me Ves Volar, 4
Rockers Hi Fi - Transmission Central, 4
Spanky Wilson & The Quantic Soul Orchestra - Don't Joke With A Hungry Man (Part 3), 4
Al Green - Standing In The Rain, 2
Donald Byrd - Love's so Far Away, 0
Jackie Mittoo And The Soul Brothers - James Bond, 0
The HitchHikers - Mr Fortune, 3
Placebo - Only Nineteen, 2
Bobby Hebb - Sunny, 2
Mungo's Hi Fi - Gideon Boot feat. General Levy (Original Mix), 0
