Lee 'Scratch' Perry and King Tubby - MFA Dub, 3
Chino - Jade Sunrise, 3
Astrud Gilberto - Canto De Ossanha (Let Go), 2
Golden Boys - Se Voce Quiser Mas Sem Bronquear, 0
Gloria Jones - Tainted Love, 3
Dionne Warwick - Do You Know The Way To San Jose, 2
Gwen McCrae - 90% Of Me Is You, 3
Stan Getz & Astrud Gilberto - One Note Samba (Live), 2
Tommy Mccook - Green Mango, 3
Stan Getz & Charlie Byrd - Desafinado, 0
Charles Bradley And The Menahan Street Band - The World (Is Going Up In Flames), 3
Charles Bradley - The World (Is Going Up In Flames), 3
Dizzy Gillespie - In A Shanty In Old Shanty Town, 0
Dub Specialist - Dub It Easy, 3
Wes Montgomery - Summertime, 0
Beastie Boys - Transitions, 0
Jorge Ben - Mas Que Nada, 3
Dusty Springfield - Son Of A Preacher Man, 3
Betty Wright - Clean Up Woman, 3
Beastie Boys - Some Dumb Cop Gave Me Two Tickets Already (Instrumental), 3
People Under The Stairs - The Breakdown, 3
Jurassic 5 - Quality Control, 3
Sergio Mendes & Brasil 66 - Mas Que Nada, 0
Cal Tjader - Pantano, 2
Elzhi & Will Sessions - Memory Lane (Instrumental), 0
Jack McDuff - Hunk O'funk, 3
Jurassic 5 - If You Only Knew (Instrumental), 3
Byron Lee - Hot Reggae, 3
RJD2 - Work, 0
Tenor Saw - Ring The Alarm, 4
King Jammy - Slow Motion Dub, 3
Sharon Jones & The Dap Kings - Make It Good To Me, 3
Ramsey Lewis Trio - Slippin' Into Darkness, 2
John Holt - Man Next Door (Got To Get Away), 2
Jimmy McGriff - Blue Juice, 2
Jorge Ben - O Namorado Da Viúva, 2
Gal Costa & Caetano Veloso - Remelexo, 0
Slickers - Johnny Too Bad, 2
Sharon Jones & The Dap Kings - People Don't Get What They Deserve, 2
Dorothy Ashby - Come Live with Me, 0
The Gaturs - The Booger Man, 2
The Chosen Few - I Love The Way You Love, 3
Stan Getz & Laurindo Almeida - Samba Da Sahra, 0
Jorge Ben - País Tropical, 0
Eddie Henderson - Inside You, 2
Al Brown - Here I Am Baby, 3
Freesom Orquestra - Rush, 2
