Althea & Donna - Uptown Top Ranking, 0
Booker T & The MG's - Time Is Tight, 0
Gregory Isaacs - Night Nurse (Kruder and Dorfmeister Session), 0
Gwen McCrae - 90% Of Me Is You, 0
Handsome Boy Modeling School - The Truth (feat. Roisin Murphy & J-Live), 0
Joăo Gilberto - De Conversa Em Conversa, 0
Joe Dukie & DJ Fitchie - Midnight Marauders, 0
Marcia Aitken - I'm Still In Love, 0
Nightmares On Wax - Morse, 0
Orquestra CBD - Tema Da Zorra, 0
Sharon Jones & The Dap Kings - Without A Heart (Instrumental), 0
The Maytals - Night and Day, 0
Toots & The Maytals - 54, 0
Bob Marley - Brand New Second Hand, 2
Jorge Ben - Menina Bonita Nao Chora, 2
Jorge Ben - Por Causa de Voce Menina, 2
King Tubby - Psalms of Dub, 2
Randy's Allstars - Mission Impossible, 2
The Zodiacs - Don't Change On Me, 2
Betty Harris - Break In The Road (feat. The Meters), 3
Bill Withers - Use Me, 3
Blackalicious - Deep In The Jungle (Instrumental), 3
Joe Dukie & DJ Fitchie - This Room, 3
Jorge Ben - Quero Esquecer Voce, 3
Massive Attack - Teardrop, 3
The Bamboos - Like Tears In Rain, 3
Jimmy Ponder - While My Guitar Gently Weeps, 0
The Skatalites - Swing Easy, 2
Jimmy Cliff - Ruby Soho, 3
Lennie Hibbert - Real Hot (RB Edit), 3
