Bill Withers - The Same Love That Made Me Laugh, 0
De La Soul - Ring Ring Ring (Ha Ha Hey), 0
Explosions - Hip Drop, 0
Grandmaster Flash - The Message (Instrumental), 0
James Knight And The Butlers - Save Me, 0
Otis Redding - (Sittin' On) The Dock Of The Bay, 0
The Beatnuts - Fluid, 0
Tim Armstrong - Wake Up, 0
Tony Alvon & The Belairs - Sexy Coffee Pot, 0
Vanessa da Mata - Não Me Deixe Só, 0
Eddie Bo - Check Your Bucket, 2
El Michels Affair - Criminology, 2
The Beatnuts - Watch Out Now (Instrumental), 2
The Dap Kings - Nervous Like Me, 2
Katchafire - Bounce, 4
Dizzy Gillespie - Matrix, 4
Tosca - Worksong, 0
The J.B.'s - Hot Pants Road, 2
Souls Of Mischief - Let Em Know (Instrumental), 2
A Tribe Called Quest - Electric Relaxation (Instrumental), 3
Beastie Boys - Hey Ladies (Instrumental), 3
The Gaturs - Cold Bear, 4
Willie Bobo & The Bo Gents - Broasted Or Fried, 3
Deltron 3030 - Positive Contact, 4
Bomb The Bass - Bug Powder Dust (K&D Session), 0
Jurassic 5 - Jayou, 4
Prince Fatty - Insane In The Brain (feat. Horseman), 0
Bobby Womack - California Dreamin', 3
Beastie Boys - Shake Your Rump (Instrumental), 4
Taggy Matcher - Root Down, 2
People Under The Stairs - The Hang Loose, 3
Edson Frederico - Bobeira, 2
Ini Kamoze - Here Comes The Hotstepper, 4
