De La Soul - 4 More (feat. Zhane), 0
Dizzy Gillespie - Matrix, 0
Explosions - Garden Of Four Trees, 0
Grandmaster Flash - The Message (Instrumental), 0
James Knight And The Butlers - Save Me, 0
Jeanne & The Darlings - How Can You Mistreat The One You Love, 0
Jurassic 5 - Red Hot (Instrumental), 0
Otis Redding - (Sittin' On) The Dock Of The Bay, 0
The Beatnuts - Fluid, 0
The Noble Knights - Sing A Simple Song, 0
Vanessa da Mata - Não Me Deixe Só, 0
A Tribe Called Quest - Luck Of Lucien (Instrumental), 2
De La Soul - Ring Ring Ring (Ha Ha Hey), 2
Inell Young - What Do You See In Her, 2
The Beatnuts - Watch Out Now (Instrumental), 2
Tony Alvon & The Belairs - Sexy Coffee Pot, 2
Tosca - Boss On The Boat, 2
Sharon Jones & The Dap Kings - How Long Do I Have To Wait For You?, 4
Sharon Jones & The Dap Kings - How Long Do I Have To Wait, 3
The Quantic Soul Orchestra - Pushin' On (feat. Alice Russell), 3
Sola Rosa - Del Ray, 3
The Bamboos - The Ghost, 5
Jorge Ben - Sem Essa No. 5, 3
Deadbeats - Pick Me Up (Nightmares On Wax Edit), 5
Sharon Jones & The Dap Kings - Trimmed, 2
Sharon Jones And The Dap Kings - How Long Do I Have To Wait, 3
Sharon Jones & The Dap Kings - Pick It Up, Lay It In The Cut, 2
Sharon Jones & The Dap Kings - Without A Heart (Instrumental), 2
Sharon Jones & The Dap Kings - You Better Think Twice, 3
Sharon Jones & The Dap Kings - Something's Changed, 2
Fela Soul - Still Ego Trippin' (Instrumental), 0
